********************
*------------------*
<------------------*
*------------------*
*------------------*
*----------------A-*
*------------------*
*------------------*
*------------------*
*********V**********