*********^**********
*------------------*
*------------------*
*------------------*
*---------P--------*
*------------------*
*------------------*
<------------------*
*-----------------A*
********************