*********V**********
*------------------*
*------------------*
*------------------*
*---------P--------*
*------------------*
*------------------*
*------------------>
*------------------*
********************