*********^**********
*------------------*
*------------------*
*------------------*
*---------O--------*
*------------------*
*------------------*
*------------------>
*-A----------------*
********************