*********V**********
*------------------*
*------------------*
*------------------*
*---------P--------*
*------------------*
*------------------*
*------------------>
*-A----------------*
********************