********************
*A-----------------*
*------------------>
*------------------*
*---------P--------*
*------------------*
*------------------*
*--------------O---*
*------------------*
*********V**********